R  1920 1080
WE ./textures/130.png
SO ./textures/102.png
NO ./textures/105.png
EA ./textures/106.png
S ./textures/22.png
C  0,108,108
F  51,51,0



  11111111111111111111111111111111
        10000010001100001110001111
        10110010011000000002101011
        10010010000011101111111111
1111111110110010011000000000000011
100000000011000001111011100111111
11110111111111011100002100111
11110111111111011101011110011
11010000110101011101010110211    
10010000011110011010000120111
10010002001010001101010110111
11000011111000111110110000N11
1101011111110101 100110110001
1101110000010111 101110110111
11020001100001111100000110011
11111111111111111111111111111