R  1920 1080
WE ./textures/106.png
SO ./textures/106.png
NO ./textures/106.png
EA ./textures/106.png
S ./textures/garg.png
C  0,108,108
F  51,51,0



  11111111111111111111111111111111
        10000000001100001110001111
        10202020200N00101000000001
        10002000000011111111110001
1111111110110002001000000000000011
1000000000110000011110111000111111
1111000111111101100000010020000001
1111000111110001100101111001111111
11010000100001001100100110011    
10000001111001101000010000011
10000002001000001100010011111
11000011111000111100110000011
1001001111110101 100100110001
110010000010011 1001100110001
11000001100001111100000000111
11111111111111111111111111111